**Verbs**
    sich anmelden (für) → to register (for)
    sich anstrengen → to make an effort
    sich ärgern (über) → to get annoyed (about)
    sich aufregen (über) → to get worked up / upset (about)
    sich bedanken (bei / für) → to thank (someone / for something)
    sich befinden → to be located / to be situated
    sich bewerben (bei / um) → to apply (at / for)
    sich beziehen (auf) → to refer (to)
    sich entscheiden (für) → to decide (on)
    sich entschuldigen (bei / für) → to apologize (to / for)
    sich erinnern (an) → to remember
    sich erkundigen (bei / nach) → to ask / inquire (someone / about something)
    sich freuen (auf / über) → to look forward to / be happy about
    sich gewöhnen (an) → to get used (to)
    sich interessieren (für) → to be interested (in)
    sich konzentrieren (auf) → to concentrate (on)
    sich kümmern (um) → to take care (of)
    sich vorbereiten (auf) → to prepare (for)
    sich verlieben (in) → to fall in love (with)
    sich wundern (über) → to be surprised / wonder (about)
    sich beeilen → to hurry
    sich benehmen → to behave
    sich bewegen → to move
    sich duschen → to take a shower
    sich entspannen → to relax
    sich entschließen → to decide, make up one’s mind
    sich erholen → to recover, rest
    sich hinlegen → to lie down
    sich setzen → to sit down
    sich umdrehen → to turn around
    sich umziehen → to change clothes
    sich verspäten → to be late
    sich vorstellen → to introduce oneself / to imagine
    sich etwas anhören → to listen to something
    sich etwas merken → to remember something
    sich etwas vorstellen → to imagine something
    sich etwas wünschen → to wish for something
    sich etwas leisten → to afford something
    sich etwas kaufen → to buy oneself something
    anbieten → to offer
    anfangen → to begin, to start
    annehmen → to accept, to assume
    ablehnen → to refuse, to reject
    abschließen → to complete, to conclude
    anfordern → to request, to demand
    ankündigen → to announce
    anwenden → to apply, to use
    aufgeben → to give up, to abandon
    aufheben → to pick up, to lift, to abolish
    ausfallen → to be canceled, to fail
    ausschließen → to exclude
    beachten → to pay attention to, to consider
    beantragen → to apply for, to request
    bedrohen → to threaten
    beeinflussen → to influence
    begründen → to justify, to give reasons
    behandeln → to treat, to deal with
    behaupten → to claim, to assert
    beobachten → to observe, to watch
    beraten → to advise, to counsel
    beschließen → to decide, to resolve
    beschränken → to limit, to restrict
    beschweren (sich) → to complain
    besitzen → to own, to possess
    bestätigen → to confirm
    bestimmen → to determine, to define
    beurteilen → to judge, to assess
    bewerten → to evaluate, to assess
    bewirken → to cause, to bring about
    bewerben (sich) → to apply
    bieten → to offer
    darstellen → to represent, to portray
    durchführen → to carry out, to conduct
    ermöglichen → to make possible, to enable
    erreichen → to reach, to achieve
    erwähnen → to mention
    erweitern → to expand, to broaden
    erzeugen → to produce, to generate
    feststellen → to determine, to establish
    fördern → to promote, to support
    gelingen → to succeed, to manage
    herstellen → to manufacture, to produce
    interpretieren → to interpret
    leisten → to achieve, to accomplish
    liefern → to deliver, to supply
    nachweisen → to prove, to demonstrate
    reduzieren → to reduce
    schätzen → to estimate, to value, to appreciate
    übertragen → to transfer, to transmit
    umsetzen → to implement, to realize
    verabschieden → to adopt (law), to say goodbye
    verfügen → to have at one’s disposal
    verhindern → to prevent
    veröffentlichen → to publish
    verschieben → to postpone
    versorgen → to supply, to provide
    verursachen → to cause
    verzichten → to do without, to renounce
    warnen → to warn
    widersprechen → to contradict
    zerstören → to destroy
    abbrechen → to cancel, to abort
    abbauen → to reduce, to dismantle
    abstimmen → to vote, to coordinate
    anregen → to stimulate, to encourage
    antreiben → to drive, to propel
    ausnutzen → to exploit, to take advantage of
    ausreichen → to be sufficient
    austauschen → to exchange, to swap
    begegnen → to encounter, to meet
    begleiten → to accompany
    begrenzen → to limit, to restrict
    belasten → to burden, to strain
    belegen → to prove, to document, to occupy (space)
    bemühen (sich) → to make an effort
    berücksichtigen → to take into account, to consider
    berühren → to touch
    beschäftigen → to employ, to occupy
    beschreiben → to describe
    besprechen → to discuss
    bestehen → to pass (an exam), to exist, to insist
    betragen → to amount to
    betreffen → to affect, to concern
    bewegen → to move, to influence
    bevorzugen → to prefer
    einfallen → to come to mind, to collapse
    eingreifen → to intervene
    einrichten → to furnish, to set up
    einschränken → to limit, to restrict
    einschätzen → to assess, to estimate
    einschließen → to include, to lock in
    einsetzen → to use, to deploy, to insert
    eintreten → to enter, to occur, to join
    empfehlen → to recommend
    entscheiden → to decide
    entwickeln → to develop
    erfordern → to require, to demand
    erkennen → to recognize, to realize
    erschließen → to develop, to open up, to infer
    erweitern → to expand, to extend
    festlegen → to determine, to define
    fordern → to demand
    gelten → to be valid, to apply
    herausfinden → to find out, to discover
    herunterladen → to download
    hinweisen → to point out, to indicate
    klagen → to complain, to sue
    nachfragen → to inquire, to demand
    nennen → to name, to mention
    nutzen → to use, to benefit
    regeln → to regulate, to arrange
    schaffen → to create, to accomplish
    scheitern → to fail
    sichern → to secure, to ensure
    steigern → to increase, to boost
    streben → to strive, to aim for
    teilnehmen → to participate
    übernehmen → to take over, to assume
    überprüfen → to check, to verify
    überzeugen → to convince
    umgehen → to handle, to deal with
    unterstützen → to support
    unterscheiden → to distinguish
    unternehmen → to undertake, to do
    vergleichen → to compare
    verhalten (sich) → to behave
    verlängern → to extend
    vermuten → to suspect, to assume
    veröffentlichen → to publish
    verschärfen → to tighten, to intensify
    versprechen → to promise
    verteilen → to distribute
    verzögern → to delay
    vorschlagen → to suggest, to propose
    wählen → to choose, to elect
    wachsen → to grow
    zweifeln → to doubt
    ablenken → to distract
    abstürzen → to crash (computer, plane)
    anpassen → to adapt, to adjust
    anstreben → to strive for, to aim at
    auftreten → to appear, to occur (problem), to perform (artist)
    ausdrücken → to express
    ausweichen → to avoid, to dodge
    beanstanden → to complain about, to object to
    beauftragen → to assign, to commission
    bedauern → to regret
    befürchten → to fear, to be afraid of
    begegnen → to meet, to encounter (by chance)
    begrüßen → to greet, to welcome
    beinhalten → to include, to contain
    bekämpfen → to fight against, to combat
    belegen → to document, to prove, to occupy (seat, place)
    benachrichtigen → to inform, to notify
    beruhigen → to calm, to reassure
    beschädigen → to damage
    beschleunigen → to accelerate, to speed up
    bestärken → to strengthen, to encourage
    bewältigen → to cope with, to manage
    durchatmen → to take a deep breath
    durchhalten → to persevere, to hold out
    einfallen → to occur to someone, to come to mind
    einmischen (sich) → to interfere, to get involved
    einsparen → to save (money, resources)
    einwandern → to immigrate
    entdecken → to discover
    entfernen → to remove
    entgehen → to escape, to miss out on
    erarbeiten → to work out, to develop
    erforschen → to research, to explore
    erlauben → to allow, to permit
    erschrecken → to scare, to frighten
    erzeugen → to generate, to produce
    fliehen → to flee, to escape
    gründen → to found, to establish
    hinzufügen → to add
    ignorieren → to ignore
    klarkommen → to cope, to manage
    meiden → to avoid
    nachahmen → to imitate
    nachholen → to catch up on
    nachschlagen → to look up (in a dictionary)
    opfern → to sacrifice
    reagieren → to react, to respond
    schildern → to describe, to portray
    schweigen → to be silent, to keep quiet
    überqueren → to cross (a street, border)
    umfassen → to include, to comprise
    umgehen (mit) → to deal with, to handle
    umwandeln → to convert, to transform
    unterbinden → to prevent, to stop
    verarbeiten → to process, to work through
    verbergen → to hide, to conceal
    verfolgen → to pursue, to follow
    vermeiden → to avoid
    verrichten → to carry out, to perform
    verstoßen (gegen) → to violate, to infringe
    verurteilen → to condemn, to sentence
    verwalten → to manage, to administer
    verweigern → to refuse, to deny
    vorbeugen → to prevent, to take precautions
    vorhersagen → to predict, to forecast
    vorschreiben → to prescribe, to stipulate
    wahrnehmen → to perceive, to notice
    widerspiegeln → to reflect, to mirror
    zerbrechen → to break, to shatter
    zusammenbrechen → to collapse, to break down
